00000000000000000000000000000000000000000000000000000100000000000000000
00000000000000000000000000000000000000000000000000000100000000000000000
00000000000000000000000000000000000000000000000000000100000000000000000
00000000000000000100000000000000000000000000000000000100000000000000000
00000000000000000100000000000000000000000000000000000100000000000007000
00000000000000000100000000000000000000000000000000000100000000000000000
00000000000000000100000000000000000000000000000000000100000000000000000
00000000000000000100000000000000000000000000000000000100000000000000000
00000000000000000100000000000000000000000000000000000100000000000000000
00000000000000000100000000000000000000000000000000000100000000000000000
00000000000000000100000000000000000000113111111303333100000000000000000
00000000000000000100000000000000000000100000000000000100000000000000000
00000000000000000100000000000000000000103333111111111100000000000000000
00000000000000000100000000000000000000100000000000000000000000000000000
00000000000000000100000000000000000000100000000000000000000000000000000
00000000000000000100000000000001111111100000000000000000000000000000000
00000000000000000100000000000000000000100000000000000000000000000000000
00000000010000000100000000000000000000100000000000000000000000000000000
00000000010000000100000000000000000000100000000000000000000000000000000
00000000010000000111111111111111000000100000000000000000000000000000000
00000000010000000000000000000000000000100000000000000000000000000000000
00000000010000000000000000000000000000100000000000000000000000000000000
00000000010000000000000000000000000000100000000000000000000000000000000
00500000010000000000000000000000000000100000000000000000000000000000000
00000000010000000000000000000000000000100000000000000000000000000000000
00000000010000000000000000000000000000100000000000000000000000000000000
00000000010000000000000000000000000000100000000000000000000000000000000
00000000000000000000000000000000000000100000000000000000000000000000000